00 01 02 03 04 05 00 01 05 05 05 05 00 01 05 05 00 01 05 05 06 07 02 03 04 05 05 05 06 07 08 09
06 07 02 02 03 04 08 10 05 05 05 05 06 10 05 05 06 07 05 05 06 07 02 02 03 04 05 05 06 07 08 09
06 07 02 02 02 03 11 10 05 05 05 05 11 10 05 05 06 07 05 05 06 07 02 02 02 03 04 05 06 07 08 09
06 10 02 02 02 02 12 12 05 05 05 05 06 10 05 05 06 07 05 05 06 07 02 02 02 02 03 04 06 07 08 09
11 10 02 02 02 02 00 01 05 05 05 05 11 10 05 05 06 07 05 05 06 07 02 02 02 02 02 03 06 07 08 09
12 12 12 12 12 12 12 12 12 12 12 12 12 12 05 05 12 12 05 05 12 12 12 12 12 12 12 12 12 05 08 09
00 01 13 16 13 16 00 01 14 15 13 16 00 01 05 05 00 01 05 05 00 01 13 16 13 16 13 16 00 01 08 09
06 10 05 05 05 05 06 10 17 18 19 19 06 07 05 20 06 07 05 20 06 07 19 19 05 20 05 05 06 07 12 12
11 10 05 05 05 05 11 10 05 05 19 19 06 07 21 22 06 07 21 22 06 07 19 19 21 22 05 05 06 07 13 16
23 24 23 24 23 24 23 24 23 24 23 24 23 24 23 24 23 24 23 24 23 24 23 24 23 24 23 24 12 12 23 24
25 26 25 26 25 26 25 26 25 26 25 26 25 26 25 26 25 26 25 26 25 26 25 26 25 26 25 26 00 01 25 26