 0 0 1 2 1 2 1 2 1 2 1 2 0 0 0 0 0 0 1 2 1 2 1 2 1 2 1 2 0 0 0 0 0 0 0 0 0 0 0 0 3 4 5 5 5 5 6 7 
 8 9 8 9 8 9 8 9 8 9 8 9 0 0 0 0 8 9 8 9 8 9 8 9 8 9 8 9 0 0 0 0 0 0 0 0 0 0 0 0 7 7 4 10 4 10 11 7 
 12 13 12 13 12 13 12 13 12 13 12 13 1 2 1 2 12 13 12 13 12 13 12 13 12 13 12 13 1 2 1 2 1 2 1 2 1 2 1 2 7 14 15 10 15 10 16 7
 8 9 17 18 8 9 8 9 8 9 8 9 8 9 8 9 8 9 17 18 8 9 8 9 8 9 8 9 8 9 8 9 8 9 8 9 17 18 17 18 7 4 19 20 4 10 21 7
 12 13 22 23 12 13 12 13 12 13 12 13 12 13 12 13 12 13 22 23 12 13 12 13 12 13 12 13 12 13 12 13 12 13 12 13 22 23 22 23 07 24 25 07 15 10 06 07 
 17 18 7 7 17 18 17 18 17 18 17 18 17 18 17 18 17 18 7 7 17 18 17 18 17 18 17 18 17 18 17 18 17 18 17 18 7 7 7 7 7 4 21 7 4 10 11 7 
 22 23 26 27 22 23 22 23 22 23 22 23 22 23 22 23 22 23 26 27 22 23 22 23 22 23 22 23 22 23 22 23 22 23 22 23 26 27 7 7 7 24 6 7 15 10 16 7 
 28 29 30 31 7 7 28 29 28 29 7 7 28 29 7 7 28 29 30 31 7 7 28 29 28 29 7 7 28 29 7 7 7 7 7 7 30 31 7 7 7 24 32 7 24 33 11 7
 34 35 36 37 38 38 34 35 34 35 38 38 34 35 38 38 34 35 36 37 38 38 34 35 34 35 38 38 34 35 38 38 38 38 39 40 36 37 41 42 43 44 45 7 45 46 16 7