00 01 02 03 04 05 00 01 00 01 02 03 04 05 00 01 00 01 02 03 06 07 00 01 00 01 02 03 04 05 00 01 08 09 02 03 04 05 08 09 00 01 00 01 00 01 00 01 02 03 04 05 10 10 02 03 11 12 00 01 00 01 08 09 02 03 08 09 02 03 08 09 02 03 08 09 02 03 00 01 08 09 00 01 11 12 11 12 00 01 10 10 02 03 13 14 15 16 16 16 16 16 02 03 16 16 16 16 16 16 16 16 17 18 16 16 17 18 16 16 16 16 16 16 16 16 19 19 00 01 00 01 02 03 11 12 00 01 02 03 08 09 00 01 02 03 04 05 20 21 22 23 00 01 24 25 02 03 22 23 00 01 24 25 02 03 22 23 00 01 06 07 08 09 13 14
26 27 02 03 28 29 30 31 32 33 02 03 28 29 30 31 32 33 02 03 06 49 30 31 32 33 02 03 28 29 30 31 26 27 02 03 28 29 10 10 32 33 32 33 32 33 32 33 02 03 34 35 10 10 02 03 32 33 32 33 32 33 26 27 02 03 10 10 02 03 10 10 02 03 10 10 02 03 32 33 10 10 32 33 32 33 32 33 32 33 10 10 02 03 16 36 37 16 16 38 16 16 02 18 16 16 39 16 39 16 39 16 02 18 16 38 02 03 16 16 16 16 39 16 39 16 16 36 32 33 26 27 02 03 32 33 32 33 02 03 10 10 32 33 02 03 28 29 26 27 32 33 40 41 42 43 02 03 44 45 40 41 42 43 02 03 44 45 40 41 06 07 10 10 46 14
11 12 02 03 47 48 08 09 00 01 02 03 47 48 08 09 00 01 02 03 04 05 08 09 00 01 02 03 47 48 08 09 11 12 02 03 47 48 10 10 00 01 00 01 00 01 00 01 02 03 50 51 10 10 02 03 00 01 00 01 00 01 11 12 02 03 10 10 02 03 10 10 02 03 10 10 02 03 00 01 10 10 00 01 00 01 00 01 00 01 10 10 02 03 16 52 37 16 16 53 16 16 17 18 16 16 16 16 16 16 16 16 17 18 54 53 02 03 16 16 16 16 16 16 16 16 16 52 00 01 11 12 02 03 00 01 00 01 02 03 10 10 00 01 02 03 47 48 11 12 00 01 02 03 24 25 02 03 22 23 02 03 24 25 02 03 22 23 02 03 04 05 10 10 13 14
32 33 02 03 34 35 10 10 32 33 02 03 28 29 10 10 32 33 02 03 28 29 10 10 32 33 02 03 28 29 10 10 32 33 02 03 28 29 10 10 32 33 32 33 32 33 55 56 57 58 12 60 59 59 59 59 61 62 63 64 63 64 63 64 02 03 10 10 02 03 10 10 02 03 10 10 02 03 30 31 10 10 32 33 32 33 55 56 59 59 65 60 57 58 16 66 37 16 16 16 16 16 57 58 16 16 16 16 67 68 67 68 02 03 67 68 02 03 16 16 16 38 16 16 16 16 16 66 65 60 59 59 59 59 61 62 63 64 02 03 10 10 32 33 02 03 34 35 32 33 32 33 02 03 32 33 02 03 32 33 02 03 32 33 02 03 30 31 02 03 34 35 10 10 16 36 
00 01 02 03 50 51 10 10 00 01 02 03 47 48 10 10 00 01 02 03 47 48 10 10 00 01 02 03 47 48 10 10 00 01 02 03 47 48 10 10 00 01 00 01 69 55 70 19 19 19 19 19 19 19 19 19 19 71 72 01 00 01 00 01 02 03 10 10 02 03 10 10 02 03 10 10 02 03 08 09 10 10 00 01 00 55 70 19 19 19 19 19 19 19 19 19 19 19 19 19 19 19 19 19 16 16 16 16 37 73 37 73 02 03 37 73 02 03 16 16 16 53 19 19 19 19 19 19 19 19 19 19 19 19 19 71 72 74 02 03 10 10 00 01 02 03 50 51 00 01 00 01 02 03 00 01 02 03 00 01 02 03 00 01 02 03 08 09 02 03 50 51 10 10 16 52
32 33 02 03 32 33 10 10 32 33 02 03 34 35 10 10 30 31 02 03 28 29 10 10 32 33 02 03 34 35 10 10 32 33 02 03 28 29 10 10 75 76 55 56 77 70 78 79 02 03 32 33 26 27 02 03 80 81 71 82 65 60 59 59 02 03 10 10 02 03 10 10 02 03 10 10 02 03 26 27 10 10 75 76 83 70 78 79 32 33 32 33 40 41 46 14 15 16 67 68 67 68 02 03 16 16 59 84 16 16 67 68 85 86 85 86 19 19 16 16 59 84 16 16 16 38 87 88 06 49 32 33 40 41 80 81 71 82 59 59 65 60 59 59 59 59 61 62 63 64 64 33 02 03 64 33 02 03 64 33 02 03 64 33 02 03 26 27 02 03 75 76 55 56 16 66
00 01 02 03 00 01 10 10 00 01 02 03 50 51 10 10 08 09 02 03 47 48 10 10 00 01 02 03 50 51 10 10 00 01 02 03 47 48 10 10 69 55 70 19 19 19 89 90 02 03 00 01 11 12 02 03 20 21 19 19 19 19 19 37 02 03 10 10 02 03 10 10 02 03 10 10 02 03 11 12 10 10 69 55 70 91 89 90 74 90 74 90 02 03 13 14 15 16 37 73 37 73 02 03 19 19 19 92 93 94 37 73 86 86 86 86 40 41 19 19 19 92 93 94 94 53 87 88 04 05 00 01 02 03 20 21 19 19 19 19 19 19 19 19 19 19 19 71 72 01 00 01 02 03 00 01 02 03 00 01 02 03 00 01 02 03 11 12 02 03 69 55 70 19 19 19
32 33 02 03 32 33 10 10 30 31 02 03 32 33 10 10 26 27 02 03 34 35 10 10 32 33 02 03 32 33 10 10 26 27 02 03 34 35 75 76 83 70 78 79 30 31 32 33 02 03 32 33 32 33 02 03 32 33 02 03 30 31 30 31 02 03 10 10 02 03 10 10 02 03 10 10 02 03 30 31 75 76 83 70 78 79 30 31 32 33 32 33 02 03 46 14 15 16 16 16 16 16 02 18 67 68 02 03 92 84 16 16 85 86 85 86 02 18 67 68 02 03 71 84 16 16 87 88 34 35 32 33 02 03 32 33 30 31 02 03 26 27 02 03 26 27 80 81 71 72 63 64 02 03 64 33 02 03 64 33 02 03 64 33 02 03 64 33 02 03 77 70 78 79 46 14
00 01 02 03 00 01 10 10 08 09 02 03 00 01 10 10 11 12 02 03 50 51 10 10 00 01 02 03 00 01 10 10 11 12 02 03 50 51 69 55 70 91 89 90 08 09 00 01 02 03 00 01 00 01 02 03 00 01 02 03 08 09 08 09 02 03 10 10 02 03 10 10 02 03 10 10 02 03 08 09 69 55 70 91 89 90 08 09 00 01 00 01 02 03 13 14 15 16 16 16 16 16 17 18 37 73 02 03 95 92 93 16 86 86 86 86 17 18 37 73 02 03 95 71 93 16 87 88 50 51 00 01 02 03 00 01 08 09 02 03 11 12 02 03 11 12 20 21 96 71 72 02 02 03 00 01 02 03 00 01 02 03 00 01 02 03 00 01 02 03 19 19 89 90 13 14
12 60 57 58 12 60 12 60 12 60 57 58 12 60 12 60 12 60 57 58 12 60 12 60 12 60 57 58 12 60 12 60 12 60 57 58 12 60 77 70 12 60 12 60 12 60 12 60 57 58 12 60 12 60 57 58 12 60 57 58 12 60 12 60 57 58 12 60 57 58 12 60 57 58 12 60 57 58 12 60 77 70 12 60 12 60 12 60 12 60 12 60 57 58 97 14 15 16 59 84 16 16 57 58 16 16 57 58 16 95 92 98 85 86 85 86 57 58 59 84 57 58 16 99 71 98 100 88 12 60 12 60 57 58 12 60 12 60 57 58 12 60 57 58 12 60 12 60 12 60 71 82 57 58 12 60 57 58 12 60 57 58 12 60 57 58 12 60 57 58 12 60 12 60 97 14
19 19 19 19 19 19 19 19 19 19 19 19 19 19 19 19 19 19 19 19 19 19 19 19 19 19 19 19 19 19 19 19 19 19 19 19 19 19 19 19 19 19 19 19 19 19 19 19 19 19 19 19 19 19 19 19 19 19 19 19 19 19 19 19 19 19 19 19 19 19 19 19 19 19 19 19 19 19 19 19 19 19 19 19 19 19 19 19 19 19 19 19 19 19 19 19 19 19 19 92 19 19 19 19 19 19 19 19 19 19 19 19 86 86 86 19 19 19 19 92 19 19 19 19 19 19 19 19 19 19 19 19 19 19 19 19 19 19 19 19 19 19 19 19 19 19 19 19 19 19 19 19 19 19 19 19 19 19 19 19 19 19 19 19 19 19 19 19 19 19 19 19 19 19 19 19