00 01 00 01 02 03 11 12 00 01 02 03 08 09 00 01 02 03 04 05 20 21 22 23 00 01 24 25 02 03 22 23 00 01 24 25 02 03 22 23 00 01 06 07 08 09 13 14
32 33 26 27 02 03 32 33 32 33 02 03 10 10 32 33 02 03 28 29 26 27 32 33 40 41 42 43 02 03 44 45 40 41 42 43 02 03 44 45 40 41 06 07 10 10 46 14
00 01 11 12 02 03 00 01 00 01 02 03 10 10 00 01 02 03 47 48 11 12 00 01 02 03 24 25 02 03 22 23 02 03 24 25 02 03 22 23 02 03 04 05 10 10 13 14
65 60 59 59 59 59 61 62 63 64 02 03 10 10 32 33 02 03 34 35 32 33 32 33 02 03 32 33 02 03 32 33 02 03 32 33 02 03 30 31 02 03 34 35 10 10 16 36 
19 19 19 19 19 19 19 71 72 74 02 03 10 10 00 01 02 03 50 51 00 01 00 01 02 03 00 01 02 03 00 01 02 03 00 01 02 03 08 09 02 03 50 51 10 10 16 52
06 49 32 33 40 41 80 81 71 82 59 59 65 60 59 59 59 59 61 62 63 64 64 33 02 03 64 33 02 03 64 33 02 03 64 33 02 03 26 27 02 03 75 76 55 56 16 66
04 05 00 01 02 03 20 21 19 19 19 19 19 19 19 19 19 19 19 71 72 01 00 01 02 03 00 01 02 03 00 01 02 03 00 01 02 03 11 12 02 03 69 55 70 19 19 19
34 35 32 33 02 03 32 33 30 31 02 03 26 27 02 03 26 27 80 81 71 72 63 64 02 03 64 33 02 03 64 33 02 03 64 33 02 03 64 33 02 03 77 70 78 79 46 14
50 51 00 01 02 03 00 01 08 09 02 03 11 12 02 03 11 12 20 21 96 71 72 02 02 03 00 01 02 03 00 01 02 03 00 01 02 03 00 01 02 03 19 37 89 90 13 14
12 60 12 60 57 58 12 60 12 60 57 58 12 60 57 58 12 60 12 60 12 60 71 82 57 58 12 60 57 58 12 60 57 58 12 60 57 58 12 60 57 58 12 60 12 60 97 14
19 19 19 19 19 19 19 19 19 19 19 19 19 19 19 19 19 19 19 19 19 19 19 19 19 19 19 19 19 19 19 19 19 19 19 19 19 19 19 19 19 19 19 19 19 19 19 19