15 16 16 16 16 16 02 03 16 16 16 16 16 16 16 16 17 18 16 16 17 18 16 16 16 16 16 16 16 16 19 19 00 01 00 01 02 03 11 12 00 01 02 03 08 09 00 01 02 03 04 05
37 16 16 38 16 16 02 18 16 16 39 16 39 16 39 16 02 18 16 38 02 03 16 16 16 16 39 16 39 16 16 36 32 33 26 27 02 03 32 33 32 33 02 03 10 10 32 33 02 03 28 29
37 16 16 53 16 16 17 18 16 16 16 16 16 16 16 16 17 18 54 53 02 03 16 16 16 16 16 16 16 16 16 52 00 01 11 12 02 03 00 01 00 01 02 03 10 10 00 01 02 03 47 48 
37 16 16 16 16 16 57 58 16 16 16 16 67 68 67 68 02 03 67 68 02 03 16 16 16 38 16 16 16 16 16 66 65 60 59 59 59 59 61 62 63 64 02 03 10 10 32 33 02 03 34 35
19 19 19 19 19 19 19 19 16 16 16 16 37 73 37 73 02 03 37 73 02 03 16 16 16 53 19 19 19 19 19 19 19 19 19 19 19 19 19 71 72 74 02 03 10 10 00 01 02 03 50 51
15 16 67 68 67 68 02 03 16 16 59 84 16 16 67 68 85 86 85 86 19 19 16 16 59 84 16 16 16 38 87 88 06 49 32 33 40 41 80 81 71 82 59 59 65 60 59 59 59 59 61 62
15 16 37 73 37 73 02 03 19 19 19 92 93 94 37 73 86 86 86 86 40 41 19 19 19 92 93 94 94 53 87 88 04 05 00 01 02 03 20 21 19 19 19 19 19 19 19 19 19 19 19 71
15 16 16 16 16 16 02 18 67 68 02 03 92 84 16 16 85 86 85 86 02 18 67 68 02 03 71 84 16 16 87 88 34 35 32 33 02 03 32 33 30 31 02 03 26 27 02 03 26 27 80 81 
15 16 16 16 16 16 17 18 37 73 02 03 95 92 93 16 37 86 86 86 17 18 37 73 02 03 95 71 93 16 87 88 50 51 00 01 02 03 00 01 08 09 02 03 11 12 02 03 11 12 20 21
15 16 59 84 16 16 57 58 16 16 57 58 16 95 92 98 37 86 85 86 57 58 59 84 57 58 16 99 71 98 100 88 12 60 12 60 57 58 12 60 12 60 57 58 12 60 57 58 12 60 12 60
19 19 19 92 19 19 19 19 19 19 19 19 19 19 19 19 86 86 86 19 19 19 19 92 19 19 19 19 19 19 19 19 19 19 19 19 19 19 19 19 19 19 19 19 19 19 19 19 19 19 19 19 